############
#.#..@.....#
#.#.####.###
#.#.#.S#.#.#
#.#.#.##.#.#
#.###..#.#.#
#.#.##.#.#.#
#.#.#..#.#.#
#.#.#.##.#.#
#.#.#..#.#.#
#.#.##.#.#.#
#.#.#..#.#.#
#.#.#.##.#.#
#..........#
############ 