############
#.........@#
#.##########
#.#......#.#
#..#####...#
####...#.###
#....#.....#
#.##########
#.#.......##
#...#####..#
#####......#
#...#...####
#.#...#....#
#S#......#.#
############

############
#@...#.....#
#..#.......#
#..#####.#.#
####.....###
#..........#
#...########
#......#...#
#..........#
#######..###
#........#.#
#..#.......#
#..#.####..#
#S.#....#..#
############

############
#.....#....#
#.###.#.#.##
#...#...#..#
#.########.#
#.#......#.#
#.#.####.#.#
#.#.#.S#.#.#
#.#.#....#.#
#.#.######.#
#.#........#
#.##########
#..#.....#@#
#.....#....#
############