############
#....#....@#
#.##...#####
#..#####...#
#.....#.##.#
#..##....#.#
####..####.#
#.....#....#
#..####.####
#..........#
#######....#
#..........#
#...#####..#
#S......#..#
############ 