############
#S###.....##
#.##..#..#@#
#.#..#..#..#
#...#..#..##
####..#..#.#
#....#..#..#
#.###..#####
#.###......#
#...#.###..#
###.#.##..##
#...#.#..#.#
#.####..#..#
#......#...#
############