############
#.....#....#
#.#.#.#.#.##
#...#...#..#
#.########.#
#.#......#.#
#.#.####.#.#
#.#.#.S#.#.#
#.#.#....#.#
#.#.######.#
#.#........#
#.##########
#.#...#...##
#...#...#.@#
############