############
#......#.#@#
##.###.#.#.#
#..#...#...#
#.##.###.#.#
#..#..S#..##
##.######..#
#..#.....#.#
#.##.###...#
#.....#..###
#.###.#....#
#.#...#.##.#
#.#.###.##.#
#..........#
############ 