############
#...##....##
#.#..##@#..#
#.#.##.###.#
#.#....#...#
#....#...###
#.##.###.#.#
#.#....###.#
#.#.##.#...#
#...#....###
#.#.####...#
#.#......#.#
#.###.####.#
#S.........#
############