############
#....@...#.#
#.######.#.#
#.#.#.S#.#.#
#.#.#.##.#.#
#.#.#..###.#
#.#.##.#.#.#
#.#.#..#.#.#
#.#.#.##.#.#
#.#.#..#.#.#
#.#.##.#.#.#
#.#.#..#.#.#
#.#.#.##.#.#
#..........#
############ 