############
#..........#
#.########.#
#........#.#
######.##..#
#......#..##
#.#.###..#.#
#.##.......#
#@#..#.#..##
##..#.#..#.#
#..###..#..#
#.###..#...#
#..#..#..#.#
#.......#S.#
############