############
##.#.....#S#
##.#.###.#.#
##.#.#.#...#
#....#.#####
#.#.##.#####
#.###.....##
#..#..#..###
##..#..#..##
#..#..#..###
#.#..#..####
#..#..#..###
##..#..#..##
###.....#.@#
############