############
#.........S#
#.####.#####
#....#.....#
###.######.#
#.........##
########...#
#..#...#.#.#
#....#.#.#.#
#.####...###
#.#....#...#
#.##########
#.#...#...##
#...#...#.@#
############