############
#....#.....#
#..#...##.##
##.#####...#
#..#@#S###.#
#.##.#.#...#
#.#..#.##.##
#..#.#.....#
#..#..######
#.###.#....#
#..#....#.##
##..####...#
#..#...#.#.#
#....#.....#
############